NO resources/textures/mossy.png
SO resources/textures/stone.png
WE resources/textures/wood.png
EA resources/textures/colorstone.png

F 176,110,18
C 18,23,176


111111111111111111111111
1000000100011000|0000001
100000010001100010000001
1000X0010X01|0001111-111
100000010001100010000001
111101110111100010000001
100000000000|0001111-111
111111-111111000|0000001
     10001  11-110000001
     1X001  10X011111111
     1-111  100010000001
     10001  1000|00W0001
     10001  100010000001
     11111  111111111111