NO resources/textures/redbrick.png
SO resources/textures/purplestone.png
WE resources/textures/nazi.png
EA resources/textures/bluestone.png

F 60,62,64
C 153,0,0

1111111111111111111111111111111111111111111111111111111111111
1E001X10100X1X10000000X00000100010000010100000000000|00000101
111-1010101110101010111111101110111010101110111-11101011101X1
1X00X000|000|0101X100X10100010|010001000000000100010100X10|01
11111-1110101010111011101010101011101110111-111111111111101X1
1X0010100010101010100010101010100000101010101X00X00X101010101
10111011111110111010011-1110101111101011101011101011101011101
10|000100000101X00000000100010000010100000100|00101000001X001
1X11111110111010111111111111111110111011101111101010111011101
1000000010100000000X1000000X101000001000100010001010100010101
101010111011101111111011111110111-111010101010111011101-10101
101010001000001X0000001X000010|X000X101X1010100010100010100X1
101110101111101110111-11111-10111-11101111101111111-111111111
10100010|0001X00101000100010001000100000001000100000000X101X1
111-10111111111111101010111110111010111110101010111-101010101
1X0010100000|00000101X100000001000101000101010001000101010|01
101010111110101110101110111111111011101111101-111111101010111
101X1010000010|010000000000X0000100X0000100010001010001000101
10101111111010111010111-1-1110111111111-1010101110101-1111101
1010000X0000100010101X00100X101X000000000010101000X01000000X1
1111111111111111111111111111111111111111111111111111111111111