NO resources/textures/mossy_plus.png
SO resources/textures/purplestone.png
WE resources/textures/bluestone.png
EA resources/textures/wood.png

F 178,184,179
C 0,94,153

11111111111111111111111111111111111
1X00010000|0|000000000001X00|X00001
10000100111011100001000011111000001111
1000X10000101000X00111100000101100|001
11110100001010000001000100X010000X1001
100001010X1010111111-11111111000001001
11-1110111101000000000000000111-111001
1000000|001-111-1111111-11101X00000111
11111101001X1100001S1X000X101111110|01
110011-1111-1100001-1000001X|000001101
1X00X10000000|000000000000101111100101
110011-1111111111111111-11101000010101
100000001|00000|00000010000011-1110101
11111101 100111111111111111110000|0|01
100001011100111X000000|000011001110101
1010X10000000|000000111110010000X101X1
1011110011111111001111111-1111-111-111
100000001  1X0000000|0000000X000000001
111111111  111111111111111111111111111