NO resources/textures/stone.xpm
SO resources/textures/wood.xpm
WE resources/textures/cobblestone.xpm
EA resources/textures/colorstone.xpm

F 2,166,48
C 10,241,245

   1111111111111111111111111
   1000000000000000000100001
1111000000000000000000|00001
1000000001111100000000111111
1000100001   100000000001
1000000001111100000000001111
1000000000000000000000000001
1000000000000000000000011-11
1000001110000000111110010001
1000001 10000000000000010N01
1111111 11111111111111111111