NO resources/textures/bluestone.xpm
SO resources/textures/colorstone.xpm
WE resources/textures/greystone.xpm
EA resources/textures/mossy.xpm

F 64,0,0
C 0,64,0

        1111111111111111111111111
        1000000000110000000000001
        1011000001110000000000X01
        1001000000000000000000X01
111111111011000001110000000000001
1X0000000011000001110111110111111
11110111111111011100000010001
11110111111111011101010010001
11000000110101011100000010001
100000000X0000001100000010001
10000000000000001101010010001
11000001110101011111011110N0111
1111X111 1110101 101111010001
11111111 1111111 111111111111